abilities	noun
ability	noun
able	adj
above-average	adj
abound	verb
abundant	adj
abundance	noun
accept	verb
acceptance	noun
acceptable	adj
accessible	adj
accommodative	adj
accomplish	verb
accomplishment	noun
accomplishments	noun
accord	verb
accordance	noun
accordantly	adverb
accurate	adj
accurately	adj
achievable	adj
achieve	verb
acknowledge	verb
acknowledgement	noun
acquit	verb
active	adj
adaptable	adj
adaptability	noun
adaptive	adj
adept	adj
adeptly	adverb
adequate	adj
adherence	noun
adherent	adj
adhesion	noun
admission	adj
admission	noun
advanced	adj
advantage	adj
advantage	noun
advantages	adj
advantages	noun
adventure	adj
adventure	noun
adventurous	adj
advice	adj
advice	noun
advisable	noun
affability	noun
affably	adverb
affinity	noun
affirmative	noun
affluent	adj
affluence	noun
afford	verb
affordable	adj
afloat	adj
agile	adj
agilely	adverb
agility	noun
agreeable	adj
agreement	adj
agreement	noun
alleviate	verb
allow	verb
allowable	adj
ambitious	adj
ambitious	noun
amenity	noun
amity	adj
amity	noun
amnesty	noun
ample	adj
amply	adverb
angel	noun
animated	adj
appeal	adj
appeal	noun
appeal	verb
appease	verb
appreciable	adj
appropriate	adj
approval	noun
approve	verb
apt	adj
aptly	adverb
aptitude	noun
aristocratic	adj
assertive	adj
asset	noun
assuage	verb
assurance	adj
assurance	noun
assurances	adj
assurances	noun
asylum	adj
asylum	noun
attain	verb
attainable	adj
attune	adj
authentic	adj
authoritative	adj
award	adj
award	verb
autonomous	adj
back	verb
backbone	noun
balanced	adj
basic	adj
bask	verb
beacon	noun
benefactor	noun
beneficial	adj
benefit	adj
benefit	noun
benefits	adj
benefits	noun
benign	adj
best-selling	adj
bloom	verb
blossom	verb
bonus	noun
boom	noun
booming	adj
boost	adj
boost	verb
breakthrough	adj
breakthrough	noun
breakthroughs	adj
breakthroughs	noun
bright	adj
brightness	noun
brilliance	noun
brisk	adj
broad	adj
brotherly	adj
bull	adj
bull	noun
bullish	adj
bullish	noun
buoyant	adj
calm	adj
calm	verb
calmness	noun
capable	adj
capability	noun
capably	adj
capitalize	verb
care	verb
careful	adj
celebrity	noun
champion	adj
champ	noun
champion	noun
charitable	adj
charitable	noun
charity	noun
chum	noun
civilization	noun
civilize	adj
civilize	verb
civil	adj
clarity	adj
classic	noun
clean	adj
cleanliness	noun
cleanse	verb
co-operation	adj
co-operation	noun
coddle	verb
cohesive	adj
cohere	verb
coherent	adj
cohesion	noun
cohesive	adj
colorful	adj
colossal	adj
comeback	adj
comeback	noun
comfort	verb
comfortable	adj
comfortable	noun
comfortably	adverb
commensurate	adj
commonsense	noun
commonsensible	adj
commonsensibly	adverb
commonsensical	adj
commodious	adj
commitment	adj
commitment	noun
compact	adj
compatible	adj
compatible	noun
competent	adj
competence	noun
competency	noun
competitive	adj
competitive	noun
complement	verb
comprehensive	adj
compromise	adj
compromise	noun
compromise	verb
compromises	adj
compromises	noun
conclusive	adj
concrete	adj
conducive	adj
conducive	noun
confer	verb
conquer	verb
conscience	noun
consistent	adj
console	verb
constructive	adj
constructive	adj
constructive	noun
content	verb
continuity	noun
contribution	adj
contribution	noun
convenient	adj
conviction	adj
conviction	noun
convince	verb
cooperate	verb
cooperation	adj
cooperation	noun
cooperative	adj
cooperatively	adverb
cordial	adj
correct	adj
cost-effective	adj
cost-saving	adj
covenant	noun
crisp	adj
dance	noun
dance	verb
dawn	verb
deal	noun
decent	adj
decency	noun
decisive	adj
decisiveness	adj
decisiveness	noun
defend	verb
defense	noun
definite	adj
definitive	adj
definitive	noun
deflationary	adj
delicacy	noun
delicate	adj
democratic	adj
dependable	adj
destine	verb
destined	adj
devout	adj
dexterity	noun
dig	verb
dignify	verb
diligence	noun
diligent	adj
diligently	adverb
diplomatic	adj
diplomatic	noun
discreet	adj
discreet	noun
discretion	noun
discriminating	adj
discriminatingly	adverb
distinct	adj
distinction	noun
distinctive	adj
distinctive	adj
distinctive	noun
distinguish	verb
diversified	adj
dream	adj
dream	noun
dreams	adj
dreams	noun
dreamy	adj
drive	noun
driven	adj
durable	adj
durability	noun
dynamic	adj
ease	noun
ease	verb
easy	adj
economical	adj
educable	adj
educated	adj
educational	adj
effective	adj
effectiveness	noun
effectual	adj
efficacious	adj
efficiency	noun
efficient	adj
egalitarian	adj
elate	verb
electrify	verb
elevate	verb
elevated	adj
eligible	adj
emancipate	verb
embolden	verb
empower	verb
empowerment	noun
enable	verb
encourage	verb
energetic	adj
energetic	noun
energize	verb
enhance	verb
enhanced	adj
enhancement	noun
enjoy	verb
enlighten	verb
enlightenment	noun
enliven	verb
enrapture	verb
enrich	verb
enrichment	noun
ensure	verb
enterprising	adj
entertain	verb
entrance	verb
entrust	verb
envision	verb
envisions	adj
envisions	noun
equality	adj
equality	noun
equitable	adj
essential	adj
established	adj
even	adverb
evenly	adverb
eventful	adj
excite	verb
exclusive	adj
excuse	verb
exhaustive	adj
exhaustively	adverb
experienced	adj
expert	adj
expressive	adj
facilitate	verb
fair	adj
fair	noun
fairly	adverb
fairness	adj
fairness	noun
famed	adj
famous	adj
farsighted	adj
fast-growing	adj
fast-paced	adj
fastest-growing	adj
fathom	verb
favor	adj
favor	noun
favored	adj
feasible	adj
feasibly	adverb
feat	noun
fertile	adj
fertile	noun
fiery	adj
fine	adj
first-class	adj
flair	noun
flame	adj
flame	noun
fluent	adj
foolproof	adj
fortunate	adj
free	adj
freedom	adj
freedom	noun
freedoms	adj
freedoms	noun
fresh	adj
friend	adj
friend	noun
friends	adj
friends	noun
friendship	adj
friendship	noun
fruitful	adj
fulfillment	adj
fulfillment	noun
full-fledged	adj
functional	adj
gain	noun
gain	verb
gem	adj
gem	noun
gems	adj
gems	noun
genial	adj
gentle	adj
genuine	adj
germane	adj
go-ahead	adj
go-ahead	noun
gold	noun
golden	adj
goodly	adverb
grail	adj
grail	noun
grand	adj
groove	verb
guarantee	noun
guarantee	verb
guardian	noun
guidance	adj
guidance	noun
gush	verb
hard-working	adj
hardy	adj
headway	noun
heal	verb
healthy	adj
healthy	noun
heart	adj
heaven	noun
help	adj
help	noun
help	verb
helpful	adj
high-quality	adj
historic	adj
holy	adj
honest	noun
honeymoon	noun
honor	adj
honor	noun
hot	adj
humanists	adj
humanists	noun
humanity	noun
idealism	noun
idealist	noun
impartial	adj
impartiality	noun
impartially	adverb
imperial	adj
impetus	noun
importance	noun
important	adj
importantly	adverb
impress	verb
impression	adj
impression	noun
impressions	adj
impressions	noun
improving	adj
improve	verb
improved	adj
improvement	noun
inalienable	adj
inclusive	adj
indebted	adj
independence	adj
independence	noun
independent	adj
individuality	noun
industrious	adj
inexpensive	adj
influential	adj
informative	adj
innocence	adj
innocence	noun
innocent	adj
innocently	adj
innovation	adj
innovation	noun
innovative	adj
insistence	adj
insistence	noun
instructive	adj
instrumental	adj
intact	adj
integral	adj
intelligence	noun
intercede	verb
interest	adj
interest	noun
interest	verb
interested	adj
interests	adj
interests	noun
intimate	adj
intricate	adj
inventive	adj
invigorate	verb
jollify	verb
just	noun
justice	adj
justice	noun
kiss	noun
kiss	verb
large	adj
large	adverb
lawful	adj
lawfully	adverb
leading	adj
lean	adj
lean	noun
learning	noun
learned	noun
legendary	adj
legitimacy	noun
legitimate	adj
legitimately	adverb
lenient	adj
leniently	adverb
less-expensive	adj
leverage	noun
leverage	verb
liberal	adj
liberation	adj
liberation	noun
liberalism	noun
liberally	adverb
lifelong	adj
light	adj
light	noun
lighten	verb
literate	adj
live	adj
logical	adj
low-cost	adj
low-risk	adj
lower-priced	adj
loyal	adj
lucrative	adj
lucrative	noun
luminous	adj
luxuriate	verb
magnetic	adj
magnify	verb
manageable	adj
mature	adj
maturely	adverb
maturity	noun
mend	verb
mentor	noun
meticulous	adj
meticulously	adj
mild	adj
minister	verb
modern	adj
modest	adj
modesty	noun
myriad	noun
natural	adj
naturally	adverb
navigable	adj
neat	adj
neatly	adverb
necessarily	adj
necessary	adj
neutralize	verb
non-violence	noun
non-violent	adj
normal	adj
noticeable	adj
nourish	verb
nourishing	adj
nourishment	noun
objective	adj
objectively	adverb
offset	verb
okay	adj
onward	adj
onward	noun
open	adj
openly	adj
openness	adj
openness	noun
optimistic	adj
orderly	adj
original	adj
originality	noun
outgoing	adj
painless	adj
painlessly	adverb
pamper	verb
patient	adj
patient	adj
patient	noun
peace	adj
peace	noun
peaceful	adj
peaceful	noun
peacefully	adverb
peacekeepers	adj
peacekeepers	noun
permissible	adj
persistent	adj
persistent	noun
personages	adj
personages	noun
pertinent	adj
piety	noun
placid	adj
plain	adj
pleasant	adj
pleasantly	adj
plentiful	adj
polished	adj
polite	adj
politeness	noun
popular	adj
popular	noun
popularity	adj
popularity	noun
portable	adj
positive	adj
posterity	noun
potential	adj
potential	noun
powerful	adj
powerfully	adverb
practicable	adj
practical	adj
pre-eminent	adj
precedent	noun
precise	adj
precisely	adverb
precision	noun
preeminent	adj
preemptive	adj
premier	adj
premium	adj
prepared	adj
press	verb
prestigious	adj
principle	adj
principle	noun
principled	adj
pro	noun
productive	adj
profit	noun
profit	verb
profitable	adj
progress	noun
progress	verb
progressive	adj
prolific	adj
prominent	adj
prominence	noun
prompt	adj
promptly	adverb
proper	adj
properly	adverb
prospect	adj
prospect	noun
prospects	adj
prospects	noun
prosperity	adj
prosperity	noun
prosperous	adj
protect	verb
protection	noun
protective	adj
prudence	adj
prudence	noun
pure	adj
purification	noun
purify	verb
purity	noun
qualified	adj
qualify	adj
qualify	verb
quench	verb
rapprochement	adj
rapprochement	noun
rationality	adj
rationality	noun
readily	adverb
ready	adj
reaffirm	noun
reaffirmation	adj
reaffirmation	noun
reason	noun
reasonable	adj
reasonably	adverb
reclaim	verb
recognition	adj
recognition	noun
recompense	noun
recompense	verb
reconcile	verb
reconciliation	adj
reconciliation	noun
record-setting	adj
recover	verb
reestablish	verb
refine	verb
refined	adj
refinement	noun
reform	noun
reform	verb
refresh	verb
rehabilitate	verb
rehabilitation	noun
reinforce	verb
reinforcement	noun
relax	verb
relaxed	adj
relevant	adj
relevance	noun
reliable	adj
reliability	noun
reliably	adverb
relieve	verb
remedy	noun
renewal	noun
renovate	verb
renovation	noun
repair	noun
repair	verb
reparation	noun
reputable	adj
rescue	noun
rescue	verb
resilient	adj
resolute	adj
resolve	adj
resolve	noun
resolve	verb
resolved	adj
resound	verb
respect	verb
responsibility	noun
responsible	adj
responsibly	adverb
responsive	adj
restful	adj
restoration	noun
restore	verb
restraint	adj
restraint	noun
resurgent	adj
reunite	verb
revelation	adj
revelation	noun
revival	noun
revive	verb
revitalize	verb
revolution	adj
revolution	noun
rich	adj
riches	noun
right	adj
right	noun
rights	adj
rights	noun
ripe	adj
risk-free	adj
robust	adj
safe	adj
salable	adj
salivate	verb
satisfy	verb
satisfying	adj
savor	verb
scenic	adj
seasoned	adj
secure	adj
securely	adverb
security	adj
security	noun
selective	adj
self-sufficiency	adj
self-sufficiency	noun
self-sufficient	adj
semblance	noun
sense	adj
sense	verb
sense	noun
sensitive	adj
sensitive	noun
settle	adj
shelter	noun
shelter	verb
shield	verb
shiny	adj
significant	adj
significance	noun
signify	verb
simple	adj
simplified	adj
simplify	verb
sincerity	adj
sincerity	noun
skill	noun
skilled	adj
sleek	adj
slender	adj
slim	adj
slim	noun
smooth	adj
soft-spoken	adj
solid	adj
solid	noun
sound	adj
soundness	noun
spacious	adj
spare	verb
sparing	adj
sparingly	adverb
sparkling	adj
special	adj
speedy	adj
spirit	adj
spirit	noun
spirited	adj
stability	adj
stability	noun
stabilize	verb
stable	adj
stable	noun
stainless	adj
stand	verb
steadiness	noun
steady	adj
stimulate	verb
stimulative	adj
stood	verb
straight	adj
streamlined	adj
strides	adj
strides	noun
strong	adj
sturdy	adj
subscribe	verb
substantial	adj
substantially	adverb
substantive	adj
subtle	adj
succeed	verb
success	adj
success	noun
successful	adj
successfully	adverb
suffice	verb
sufficient	adj
sufficiently	adverb
suggestions	adj
suggestions	noun
suit	verb
suitable	adj
sunny	adj
superior	adj
support	verb
survival	noun
survive	verb
survivor	noun
sustainability	adj
sustainability	noun
sustainable	adj
sustainable	noun
sustained	adj
sweet	adj
sweeten	verb
sweetheart	noun
sweetly	adverb
sweetness	noun
swift	adj
swiftness	noun
tantalize	verb
taste	noun
temperance	noun
temperate	adj
tender	adj
tenderly	adverb
tenderness	noun
thorough	adj
thrift	noun
thrifty	adj
thrive	verb
thriving	adj
tickle	verb
timely	adj
titillate	verb
tolerant	adj
tolerate	verb
toleration	noun
top	adj
tradition	noun
traditional	adj
treat	noun
trim	adj
trust	adj
trust	noun
trust	verb
unbiased	adj
unbound	adj
unbroken	adj
unconditional	adj
unconventional	adj
understanding	adj
understanding	noun
undisputed	adj
unencumbered	adj
uniform	adj
uniformly	adverb
unique	adj
unity	adj
unity	noun
universal	adj
unlimited	adj
unrestricted	adj
unscathed	adj
untouched	adj
untrained	adj
upfront	adj
upgrade	verb
uplift	verb
upright	adj
upscale	adj
upward	adj
usable	adj
useful	adj
usefulness	noun
utilitarian	adj
valid	adj
validity	noun
valuable	adj
value	verb
values	adj
values	noun
vast	adj
vastly	adverb
vastness	adverb
venerate	verb
verifiable	adj
versatile	adj
versatility	noun
viable	adj
viability	noun
victorious	adj
victory	adj
victory	noun
vigilance	noun
vigilant	adj
vigilant	noun
vigorous	adj
vigorously	adverb
vintage	adj
voluntarily	adverb
voluntary	adj
warm	adj
warmth	noun
wealthy	adj
welfare	adj
welfare	noun
well	adj
well	adverb
well-educated	adj
well-established	adj
well-positioned	adj
well-publicized	adj
white	adj
wide	adj
wide-open	adj
wide-ranging	adj
worship	verb
youthful	adj
